NO textures/test.png




EA textures/wood.png

        SO       textures/redbrick.png

WE textures/eagle.png
C 10,130,130

        F 1,120,39


        1111111111111111111111111
        1000000000110000D00000001
        1011000001110000100000001
        100100000000000000001D101
111111111011000001110000000000001
1000000000110000011101111D1111111
11110110111111011100000010001
11110101111111011101010010001
11000000110101011100000010001
10000000000000001100000010N01
10000000000000001101010010001
11000001110101011111011110D011
11110111 1110101 101111010001
11111111 1111111 111111111111
