NO textures/testcub.png




EA textures/testcub.png

        SO       textures/barrel.png

WE textures/testcub.png
C 10,130,130

        F 1,120,39


11111
10001
100011111
10001
11111

