NO textures/test.png
WE textures/colorstone.png
C 10,130,130
SO textures/redbrick.png

F 0,0,0
EA textures/wood.png

        1111111111111111111111111
        1000000000110000000000001
        1000000000110000000000001
        1000000000110000000000001
        1000000000110000000000001
        1000000000110000000000101
        1000000000110000000000D01
        1011000001110000000000101
        1001000000000000000000001
111111111011000001110000000000001
1000000000110000011101111D1111111
11110110111111011100000010001
11110101111111011101010010001
11000000110101011100000010001
10000000000000001100000010N01
10000000000000001101010010001
11000001110101011111011110D011
11110111 1110101 101111010001
11111111 1111111 111111111111
