NO textures/testcub.png
WE textures/testcub.png
SO textures/testcub.png
C 10,130,131

F 120,120,250
EA textures/testcub.png


111111
100001
10N001
100001
111111
1

11111
1S001
10001
10001
10001
11111


        1111111111111111111111111
        1000000000110000000000001
        1011000001110000000000001
        1001000000000000000000001
111111111011000001110000000000001
100000000011000001110111101111111
11110110111111011100000010001
11110101111111011101010010001
11000000110101011100000010001
10000000000000001100000010N01
10000000000000001101010010001
110000011101010111110111100011
11110111 1110101 101111010001
11111111 1111111 111111111111
