NO textures/test.png
SO textures/redbrick.png
WE textures/colorstone.png
EA textures/wood.png

F 0,0,0
C 30,30,0

         11111111111111111111111
        1000000000110000000000001
        1011000001110000000000001
        1001000000000000000000001
 11111111011000001110000000000001
1000000000110N000111011110111111 
11110111111111011100000010001
11110111111111011101010010001
11000000110101011100000010001
10000000000000001100000010001
10000000000000001101010010001
11000001110101011111011110N0111
11110111 1110101 101111010001
11111111 1111111 111111111111
