NO textures/testcub.png
WE textures/testcub.png
C 10,130,130
SO textures/testcub.png

F 0,0,0
EA textures/testcub.png

         11111111111111111111111
        1000000000110000000000001
        1011000001110000000000001
        1001000000000000000000001
 11111111011000001110000000000001
1000000000110000011101111D111111
11110110111111011100000010001
11110101111111011101010010001
11000000110101011100000010001
10000000000000001100000010N01
10000000000000001101010010001
110000011101010111110111100D11
11110111 1110101 101111010001
11111111 1111111 111111111111
